97 97 97 97 97 97 97 97 97 97 97 97 97 97 97 97 97 97 97 97 97 97 97 97 97 97 03 97 97 97 97 97 97 97 97 97 97 97 97 97 97 97 97 97 14 14 14 14 14 14 14 14 14 14 14
97 04 04 04 04 04 04 04 04 04 04 04 04 04 04 04 10 15 00 00 00 00 00 00 00 00 03 00 00 00 00 00 00 00 00 00 00 00 00 00 13 07 03 14 14 14 14 14 14 14 14 14 14 14 14
97 04 12 04 04 04 04 04 04 04 04 04 04 04 04 04 04 15 00 00 00 00 00 00 00 00 03 03 03 03 03 06 03 00 00 00 00 00 00 00 03 06 03 07 07 14 14 14 14 14 14 14 14 14 14
97 04 04 04 04 04 04 04 04 11 04 04 04 04 04 04 04 15 00 00 00 00 00 00 00 00 00 00 00 00 00 00 03 03 03 03 03 03 03 03 03 00 00 00 07 07 07 14 14 14 14 14 14 14 14
97 04 04 04 04 04 04 04 04 04 04 04 10 04 04 04 04 15 00 00 00 00 00 00 00 00 00 00 00 00 00 00 00 00 00 00 00 00 00 00 00 00 00 00 00 07 07 07 14 14 14 14 14 14 14
97 04 04 04 04 04 04 04 04 04 04 04 04 04 04 10 15 00 00 00 00 00 00 00 00 00 00 00 00 00 00 00 00 00 00 00 00 00 00 00 00 00 00 00 00 00 00 07 07 14 14 14 14 14 14
97 04 04 04 04 04 04 04 04 04 04 04 04 04 04 15 00 00 00 00 00 00 00 00 00 00 00 00 00 00 00 00 00 00 00 00 00 00 00 00 00 00 00 00 00 00 00 00 07 07 07 14 14 14 14
97 04 11 04 04 04 04 04 04 10 04 04 04 04 15 00 00 00 00 00 00 00 00 00 00 00 00 00 00 00 00 00 00 00 00 00 00 00 00 00 00 00 00 00 00 00 00 00 00 07 03 14 14 14 14
97 04 04 04 04 04 10 04 04 04 04 04 04 04 15 00 00 00 00 00 00 00 00 00 00 00 00 00 01 00 00 00 00 00 00 00 00 00 00 00 00 00 00 00 00 00 00 00 00 00 03 00 00 00 97
97 04 04 04 04 04 04 04 04 04 04 04 10 15 00 00 00 00 00 00 01 01 01 01 01 01 01 01 01 01 01 01 01 01 01 00 00 00 00 00 00 00 00 00 00 00 00 00 00 00 03 00 00 00 97
97 04 04 04 04 04 04 04 04 04 04 04 15 00 00 00 01 01 01 01 01 01 01 01 01 01 01 01 01 01 01 01 01 01 01 01 00 00 00 00 00 00 00 00 00 00 00 00 00 00 03 13 00 00 97
97 04 04 04 04 04 11 04 04 04 04 15 00 00 00 01 01 01 01 01 01 01 01 01 01 01 01 01 01 01 01 01 01 01 01 01 00 00 00 00 00 00 00 00 00 00 00 00 00 00 03 00 00 00 97
97 04 04 04 04 04 04 04 04 10 15 00 00 00 00 01 01 01 01 01 01 01 01 01 10 01 01 01 01 01 01 01 01 01 01 01 01 00 00 00 00 00 00 00 00 00 00 00 00 00 03 00 00 00 97
97 04 04 10 04 04 04 04 04 04 15 00 00 00 01 01 01 01 01 01 01 01 01 01 01 01 01 01 01 01 01 01 01 01 01 01 01 00 00 00 00 00 00 00 00 00 00 00 00 00 03 00 00 10 97
97 04 04 04 04 04 04 04 04 15 00 00 00 05 05 05 05 05 01 01 01 01 01 01 01 01 01 01 01 01 01 01 01 01 01 01 01 01 00 00 00 00 00 00 00 00 00 00 00 00 03 00 00 00 97
97 10 04 04 04 04 10 04 15 00 00 00 00 05 05 05 05 05 05 05 01 01 01 01 01 01 01 01 01 01 01 01 01 01 01 01 01 01 01 00 00 00 00 00 00 00 00 00 00 00 03 00 00 00 97
97 15 15 15 15 15 15 15 00 00 00 00 00 01 01 01 01 01 05 05 05 01 01 01 01 01 01 01 01 01 01 01 01 01 01 01 01 01 01 01 01 01 01 01 01 01 01 00 00 00 03 00 00 00 97
97 00 00 00 00 00 00 00 00 00 00 00 00 01 01 01 01 01 01 05 05 05 05 01 01 01 01 01 01 01 01 01 01 01 01 01 01 01 01 01 01 01 01 01 01 01 01 01 01 01 03 00 00 00 97
97 00 00 00 00 00 00 00 00 00 00 00 01 01 01 01 01 01 01 01 05 05 05 05 05 05 05 05 01 01 01 01 01 01 01 01 01 01 01 10 01 01 01 01 01 01 01 01 01 01 03 00 00 00 97
97 00 00 00 00 00 00 00 00 00 00 00 01 01 01 01 01 01 01 01 01 05 05 05 05 05 11 05 05 01 01 01 01 01 01 01 01 01 01 01 01 01 01 01 01 01 01 01 01 01 03 00 00 00 97
97 00 00 00 00 00 00 00 00 00 00 00 01 01 01 01 01 01 01 01 01 01 05 05 05 05 05 05 05 05 01 01 01 01 01 01 01 01 01 01 01 01 01 01 01 01 01 01 01 01 03 00 00 00 97
97 00 00 00 00 00 00 00 00 00 00 00 01 01 01 01 01 01 01 01 01 01 01 01 01 01 01 01 05 05 05 01 01 01 01 01 01 01 01 01 01 01 01 01 01 01 01 01 01 01 03 00 00 00 97
97 00 00 00 00 00 00 00 00 00 00 00 00 01 01 01 01 01 01 01 01 01 01 01 01 01 01 01 01 05 05 05 05 05 01 01 01 01 01 01 01 01 01 01 01 01 01 01 01 01 03 00 00 00 97
97 00 00 00 00 00 00 10 00 00 00 00 00 00 00 01 01 01 01 01 01 01 01 01 01 01 01 01 01 01 05 05 05 05 05 01 01 01 01 05 05 05 05 05 05 05 05 05 05 05 06 01 00 00 97
97 00 00 00 00 00 00 00 00 00 00 00 00 00 00 00 00 01 01 01 01 01 01 01 01 01 01 01 01 01 01 01 05 05 05 05 01 01 01 05 05 05 05 05 05 05 05 05 05 05 06 01 01 00 97
08 00 00 00 00 00 00 00 00 00 00 00 00 00 00 00 00 00 00 01 01 01 01 01 01 01 01 01 01 01 01 01 01 01 05 05 05 05 05 05 01 01 01 01 01 01 01 01 01 01 03 01 01 00 97
97 08 00 08 00 00 00 00 00 00 00 00 00 00 00 00 00 00 00 00 00 00 01 01 01 01 01 01 01 01 01 01 01 01 01 05 05 05 05 01 01 01 01 01 01 01 01 01 01 01 03 01 01 00 97
97 08 08 00 00 00 00 00 00 00 00 00 00 00 00 00 00 00 00 00 00 00 00 00 01 01 01 01 01 01 01 01 01 01 01 05 05 01 01 01 01 01 01 01 01 01 01 01 01 01 03 01 01 00 97
97 08 08 08 00 00 00 00 00 00 00 00 00 00 00 00 00 00 08 00 00 00 00 00 00 01 01 01 01 01 01 00 00 00 00 00 00 01 01 01 01 01 01 01 01 01 01 01 01 01 03 01 01 00 97
97 08 08 08 08 00 00 00 00 00 00 00 00 00 00 00 00 00 08 00 00 00 00 00 00 00 00 00 00 00 00 00 00 00 00 98 00 00 00 01 01 01 01 01 01 01 01 01 01 01 03 01 01 00 97
97 08 08 08 08 00 00 00 00 00 00 00 00 00 00 00 00 08 08 08 08 08 00 00 00 00 00 00 00 00 00 00 00 00 00 00 00 00 00 00 00 01 01 01 01 01 00 01 01 01 03 01 00 00 97
97 08 08 08 08 00 00 00 00 08 08 00 00 00 00 00 00 08 08 08 08 08 08 00 00 00 00 00 00 00 00 00 00 00 00 00 00 00 00 00 00 00 01 01 01 00 00 00 01 01 03 00 00 00 97
97 08 08 08 08 02 08 08 08 08 08 00 00 00 00 00 08 08 08 08 08 08 00 00 00 00 00 00 00 00 00 00 00 00 00 00 00 00 00 00 00 00 00 00 00 00 00 00 00 00 03 00 00 00 97
97 08 08 08 08 02 08 08 08 08 08 00 00 00 00 00 00 08 08 08 08 08 00 00 00 00 00 00 00 00 00 00 00 00 00 00 00 00 00 00 00 00 00 00 00 00 00 00 00 03 03 00 00 00 97
97 08 08 08 08 02 08 08 08 08 08 00 00 00 00 00 00 08 08 08 08 08 00 00 10 00 00 00 00 00 00 00 00 00 00 00 00 00 00 00 00 00 00 00 00 00 00 00 00 03 00 00 13 00 97
97 08 08 08 08 02 08 08 08 08 08 08 08 00 00 00 00 02 08 08 08 08 00 00 00 00 00 08 08 08 08 00 00 00 00 00 00 00 00 10 00 00 00 00 00 00 00 00 03 00 00 00 00 00 97
97 08 02 02 02 02 08 08 08 08 08 08 08 08 08 08 08 02 08 08 08 08 00 00 00 00 00 08 08 08 08 00 00 00 00 00 00 00 00 00 00 00 00 00 00 00 00 00 03 00 00 00 00 00 08
97 08 02 08 08 02 08 08 08 08 08 08 08 02 02 02 08 02 08 08 08 08 00 00 00 00 00 08 08 08 08 00 00 00 00 00 00 00 00 00 00 00 00 00 00 00 00 03 03 00 00 00 00 08 08
97 08 02 08 08 02 02 02 02 11 02 02 02 02 08 02 02 02 08 08 08 08 00 00 00 08 00 08 08 08 08 00 00 00 00 00 00 00 00 00 00 00 00 00 08 08 08 03 03 08 08 08 08 08 08
97 08 02 13 02 02 08 08 08 08 08 08 08 02 08 02 08 02 08 08 08 08 08 08 08 08 08 08 08 08 08 08 08 08 08 00 00 00 00 00 00 00 00 00 08 08 08 08 08 08 08 08 08 08 08
97 08 08 08 08 08 08 08 08 08 08 08 08 02 13 02 08 02 02 02 02 02 02 02 02 02 02 02 02 02 02 02 02 08 08 08 08 08 00 08 08 08 08 08 08 08 08 08 08 08 08 08 08 08 08
97 97 97 97 97 97 97 97 97 97 97 97 97 97 97 97 97 97 97 97 97 97 97 97 97 97 97 97 97 97 97 97 02 02 02 02 02 02 02 97 97 97 97 97 97 97 97 97 97 97 97 97 97 97 97
